```````````````````````````````````````````````````````````````
`                                                             `
`                                                             `
`                                                             `
`                                                             `
`                                                             `
`                                                             `
`                                                             `
`                                                             `
`                                                             `
`                                                             `
`                                                             `
`            #####################################            `
`            #      #                            #            `
`            #          ☠                        #            `
`            #      #              @             #            `
`            #      #    ⚔⍬⇟⌑✹                   #            `
`            ########                            #            `
`            #                                   #            `
`            #####################################            `
`                                                             `
`                                                             `
`                                                             `
`                                                             `
`                                                             `
`                                                             `
`                                                             `
`                                                             `
`                                                             `
`                                                             `
`                                                             `
```````````````````````````````````````````````````````````````